WWWWWWWWWWWWWWWWWWWWWWWWWWWWWWWW
W1 __________________________ 2W
W ____________________________ W
W______________________________W
W__W___WWWWWWW___W______W______W
W__W_____________W______W______W
W__W_________W___W______W______W
W__W__W______W___W____WWWWWWWWWW
W__W__W______W___W________W____W
W__W__W______W___W________W____W
W__W__W___________________W____W
W_____W________________________W
W______________________________W
W ____________________________ W
W3 __________________________ 4W
WWWWWWWWWWWWWWWWWWWWWWWWWWWWWWWW