WWWWWWWWWWWWWWWWWWWWWWWWWWWWWWWW
W1 __________________________ 2W
W ____________________________ W
W______________W___________W___W
W___WWWWWWWWW__W___________W___W
W_______W______W___________W___W
W_______W______W___________W___W
W_______W______WWWWWW______W___W
W_______W______W______WWWWWW___W
W_______W______W___________W___W
W_______W______W___________W___W
W_______W______W___________W___W
W______________W___________W___W
W ____________________________ W
W3 __________________________ 4W
WWWWWWWWWWWWWWWWWWWWWWWWWWWWWWWW