WWWWWWWWWWWWWWWWWWWWWWWWWWWWWWW
W1 _________________________ 2W
W W_W_W_W_W_W_W_W_W_W_W_W_W_W W
W_____________________________W
W_W_W_W_W_W_W_W_W_W_W_W_W_W_W_W
W_____________________________W
W_W_W_W_W_W_W_W_W_W_W_W_W_W_W_W
W_____________________________W
W_W_W_W_W_W_W_W_W_W_W_W_W_W_W_W
W_____________________________W
W_W_W_W_W_W_W_W_W_W_W_W_W_W_W_W
W_____________________________W
W W_W_W_W_W_W_W_W_W_W_W_W_W_W W
W3 _________________________ 4W
WWWWWWWWWWWWWWWWWWWWWWWWWWWWWWW