WWWWWWWWWWWWWWWWWWWWWWWWWWWWWWWW
W1 __________________________ 2W
W _W_W_W_W_W_W_W_W_W_W_W_W_W_W W
W______________________________W
W__W_W_W_W_W_W_W_W_W_W_W_W_W_W_W
W______________________________W
W_W_W_W_W_W_W_W_W_W_W_W_W_W_W__W
W______________________________W
W______________________________W
W__W_W_W_W_W_W_W_W_W_W_W_W_W_W_W
W______________________________W
W_W_W_W_W_W_W_W_W_W_W_W_W_W_W__W
W______________________________W
W W_W_W_W_W_W_W_W_W_W_W_W_W_W_ W
W3 __________________________ 4W
WWWWWWWWWWWWWWWWWWWWWWWWWWWWWWWW