WWWWWWWWWWWWWWWWWWWWWWWWWWWWWWWW
W1 __________________________ 2W
W ____________________________ W
W ____________________________ W
W_________________________W____W
W_________________________W____W
W_________________________W____W
W_______W_____WWWWW_______W____W
W_________________W_______W____W
W_________________W_______W____W
W_________________W_______W____W
W_________________WWWWWWWWW____W
W______________________________W
W______________________________W
W3 __________________________ 4W
WWWWWWWWWWWWWWWWWWWWWWWWWWWWWWWW